麻阳	toponym
石家庄日报	other proper noun
环球财讯	other proper noun
中华日报	other proper noun
川汇	toponym
黑龙江日报	other proper noun
工人日报	other proper noun
重庆日报	other proper noun
Bahrain	transcribed toponym
宁夏卫视	other proper noun
赢周刊	other proper noun
麻辣烫	noun
Palikir	transcribed toponym
辽宁广播电视报	other proper noun
湖州日报	other proper noun
揭阳信息港	other proper noun
Dominican_Republic	transcribed toponym
时代周报	other proper noun
甘肃卫视	other proper noun
新城快报	other proper noun
汉阳	toponym
卤牛肉	noun
河北日报	other proper noun
特古巴加尔巴	transcribed toponym
红网	other proper noun
汕头都市报	other proper noun
镇江日报	other proper noun
Donews	other proper noun
Islands	transcribed toponym
青海广播电台	other proper noun
成报	other proper noun
沙湾	toponym
ship	noun
上海学生英文报	other proper noun
helsinki	transcribed toponym
santiago	transcribed toponym
萝岗区	toponym
Thimphu	transcribed toponym
中人网	other proper noun
沐川	toponym
中国新闻网	other proper noun
Guinea	transcribed toponym
广元日报	other proper noun
天津老年时报	other proper noun
重庆新闻网	other proper noun
伊吾	toponym
辽宁广播电台	other proper noun
maseru	transcribed toponym
offices_in_yaren_district	transcribed toponym
家常豆腐	noun
肃州	toponym
香港联合报	other proper noun
涡轮风扇飞机	noun
三峡商报	other proper noun
冰糖湘莲	noun
Tokyo	transcribed toponym
lilongwe	transcribed toponym
网络世界	other proper noun
红烧猪蹄	noun
鱼头豆腐汤	noun
宜秀区	toponym
Bujumbura	transcribed toponym
岳西	toponym
高青	toponym
炸茄盒	noun
特伦顿	toponym
酥皮月饼	noun
India	transcribed toponym
居巢	toponym
兵团电视台	other proper noun
殷都	toponym
水煮鱼	noun
经济观察报	other proper noun
干煸豆角	noun
留尼旺岛	transcribed toponym
Slovenia	transcribed toponym
东莞日报	other proper noun
中国体育报	other proper noun
三峡日报	other proper noun
肯塔基	transcribed toponym
山药排骨汤	noun
椰蓉球	noun
慕斯蛋糕	noun
戚风蛋糕	noun
乙	numeral
证券时报	other proper noun
Yahoo	organization/group name
玉田	toponym
朝鲜冷面	noun
人间福报	other proper noun
陇南市	toponym
supersonic	noun
南苏丹	transcribed toponym
四喜丸子	noun
青冈	toponym
现代消费报	other proper noun
万科	organization/group name
寻乌	toponym
广西卫视	other proper noun
江苏卫视	other proper noun
武汉在线	other proper noun
大特克	transcribed toponym
中国建设报	other proper noun
乌伊岭	toponym
Bogota	transcribed toponym
北关	toponym
中国证券报	other proper noun
邕宁区	toponym
韭菜盒子	noun
buoy	noun
内丘	toponym
Syria	transcribed toponym
中国展会网	other proper noun
吉林卫视	other proper noun
体育周报	other proper noun
大众电脑报	other proper noun
海口	toponym
新浪	other proper noun
五仁月饼	noun
Comoros	transcribed toponym
瀍河回族区	toponym
海峡卫视	other proper noun
华商晨报	other proper noun
煎饼	noun
郑州晚报	other proper noun
Algiers	transcribed toponym
湖里	toponym
少年儿童故事报	other proper noun
鸡蛋灌饼	noun
深圳热线	other proper noun
山西新闻网	other proper noun
东北新闻网	other proper noun
宁夏广播电台	other proper noun
阿布扎比	transcribed toponym
p'yongyang	transcribed toponym
lisbon	transcribed toponym
莲藕排骨汤	noun
辽宁卫视	other proper noun
尧都	toponym
巴巴多斯岛	toponym
蒜蓉西兰花	noun
老醋花生	noun
公教报	other proper noun
Tunis	transcribed toponym
经济参考报	other proper noun
奶茶	noun
呼和浩特新闻网	other proper noun
Honduras	transcribed toponym
齐鲁网	other proper noun
Apia	transcribed toponym
北京娱乐信报	other proper noun
汉台	toponym
墉桥	toponym
365地产家居网	other proper noun
luanda	transcribed toponym
太原晚报	other proper noun
大众网	other proper noun
首尔	transcribed toponym
拔丝山药	noun
天津电视台	other proper noun
兴隆台	toponym
油焖大虾	noun
Akmola	transcribed toponym
中学生阅读报	other proper noun
馄饨	noun
沈阳日报	other proper noun
西藏日报	other proper noun
修文	toponym
麻山	toponym
设计前沿	other proper noun
Quito	transcribed toponym
卢森堡市	transcribed toponym
Kyyiv	transcribed toponym
紫菜蛋花汤	noun
佛蒙特	toponym
酱牛肉	noun
茂名日报	other proper noun
河源日报	other proper noun
四川商情网	other proper noun
castries	transcribed toponym
上海日报	other proper noun
松岭区	toponym
豆角焖面	noun
热狗面包	noun
安徽日报	other proper noun
劳动报	other proper noun
美报	other proper noun
臭豆腐	noun
ulaanbaatar	transcribed toponym
Yerevan	transcribed toponym
香菇油菜	noun
水煮肉片	noun
吉林电视台	other proper noun
伊春广播电视报	other proper noun
姿尚女性网	other proper noun
合川区	toponym
turboprop	noun
Prague	transcribed toponym
香港辕门报	other proper noun
New_Caledonia	transcribed toponym
湖南电视台	other proper noun
香洲	toponym
酸辣汤	noun
新安晚报	other proper noun
卤肉饭	noun
烤羊肉串	noun
东海岛	toponym
河南法制报	other proper noun
茌平	toponym
IQ妈咪网	other proper noun
涵江	toponym
芙蓉虾	noun
Copenhagen	transcribed toponym
Nicosia	transcribed toponym
焦点家居网	other proper noun
南川区	toponym
东方汽车网	other proper noun
滴道	toponym
江苏电视台	other proper noun
北青网	other proper noun
中国城市轨道交通网	other proper noun
malabo	transcribed toponym
西祠胡同	other proper noun
瘾科技	other proper noun
地铁	noun
Colombia	transcribed toponym
Basse-Terre	transcribed toponym
南京晨报	other proper noun
卓资	toponym
海南日报	other proper noun
卓尼	toponym
岳塘	toponym
俄通社	other proper noun
Nassau	transcribed toponym
苦瓜炒肉片	noun
岱岳	toponym
岳阳新闻网	other proper noun
燕麦饼干	noun
红烧豆腐	noun
21世纪报	other proper noun
瑞安	toponym
apia	transcribed toponym
天涯网	other proper noun
良庆区	toponym
南国今报	other proper noun
田家庵	toponym
Tanzania	transcribed toponym
人民日报海外版	other proper noun
旬阳	toponym
kathmandu	transcribed toponym
kabul	transcribed toponym
高盛	organization/group name
大庆日报	other proper noun
堪萨斯	transcribed toponym
安徽老年报	other proper noun
中评社	other proper noun
安卓	other proper noun
秦州	toponym
北大商业评论	other proper noun
中华时报	other proper noun
大江网	other proper noun
爱美网	other proper noun
吐司	noun
远程飞机	noun
闽西日报	other proper noun
e时代周报	other proper noun
Kigali	transcribed toponym
元坝	toponym
Dushanbe	transcribed toponym
福州晚报	other proper noun
申江服务导报	other proper noun
选车网	other proper noun
云南日报	other proper noun
宁洱	toponym
耀州	toponym
三秦都市报	other proper noun
廊坊新闻网	other proper noun
人民法院报	other proper noun
常德网	other proper noun
云浮信息	other proper noun
人口导报	other proper noun
Laos	transcribed toponym
天津日报	other proper noun
上汤娃娃菜	noun
翠峦	toponym
Russia	transcribed toponym
玉米饼	noun
国际商报	other proper noun
口水鸡	noun
解放日报	other proper noun
厦门电视台	other proper noun
中国汽车网	other proper noun
中国台湾网	other proper noun
石家庄热线	other proper noun
世华财讯	other proper noun
山西农民报	other proper noun
营口日报	other proper noun
云南网	other proper noun
惠州日报	other proper noun
南京在线	other proper noun
亚洲电视台	media	proper	noun
海珠	toponym
呈贡	toponym
昔阳	toponym
赛螃蟹	noun
正宁	toponym
徐水	toponym
中国山东网	other proper noun
北京科技报	other proper noun
信息早报	other proper noun
亚松森	transcribed toponym
书刊报	other proper noun
禹会区	toponym
炖排骨	noun
bamako	transcribed toponym
managua	transcribed toponym
Ethiopia	transcribed toponym
Sikkim	transcribed toponym
罗宋汤	noun
Reunion	transcribed toponym
闺蜜网	other proper noun
楚天金报	other proper noun
裕安	toponym
东南卫视	other proper noun
渝北	toponym
豆沙包	noun
北京电视台	other proper noun
阜南	toponym
子洲	toponym
52硬件网	other proper noun
桑植	toponym
镇巴县	toponym
扬州日报	other proper noun
电饭锅蛋糕	noun
吉布提市	transcribed toponym
黄桥烧饼	noun
Lebanon	transcribed toponym
沈北新区	toponym
镇康	toponym
Republic_of_the_Congo	transcribed toponym
福山	toponym
皮尔	toponym
浙江卫视	other proper noun
重庆晨网	other proper noun
闽南日报	other proper noun
武强	toponym
沙坡头	toponym
wps	software	proper	noun
中文业界资讯站	other proper noun
中国教师报	other proper noun
蛤蜊蒸蛋	noun
朔城	toponym
西藏广播影视报	other proper noun
damascus	transcribed toponym
大渡口	toponym
岭东	toponym
亚松森	toponym
江南时报	other proper noun
Google	organization/group name
Sierra_Leone	transcribed toponym
揭阳日报	other proper noun
吉林广播电台	other proper noun
皮特克恩岛	transcribed toponym
佛跳墙	noun
凉拌木耳	noun
大众网络报	other proper noun
国语日报	other proper noun
重庆晚报	other proper noun
rangoon	transcribed toponym
abu_dhabi	transcribed toponym
海南特区法制报	other proper noun
山西之窗	other proper noun
21世纪环球报道	other proper noun
假日100天	other proper noun
中国包装报	other proper noun
South_Africa	transcribed toponym
南沙区	toponym
宾阳	toponym
Mongolia	transcribed toponym
千层肉饼	noun
荣成日报	other proper noun
珠晖	toponym
libreville	transcribed toponym
中国畜牧报	other proper noun
Basseterre	transcribed toponym
Sudan	transcribed toponym
antananarivo	transcribed toponym
巨鹿	toponym
帕皮提	transcribed toponym
风尚中国	other proper noun
南方农村报	other proper noun
三门峡日报	other proper noun
闻康网	other proper noun
金口河	toponym
都市女报	other proper noun
西陵	toponym
周村	toponym
Mbabane	transcribed toponym
老边	toponym
武清	toponym
安道尔共和国	transcribed toponym
四川农村日报	other proper noun
腾讯网	other proper noun
宣汉	toponym
monaco	transcribed toponym
小学生周报	other proper noun
C114	other proper noun
疏附	toponym
无忧车网	other proper noun
鸡汤	noun
Amsterdam	transcribed toponym
星岛地区报	other proper noun
中站	toponym
生活周刊	other proper noun
沙琪玛	noun
中评社	media	proper	noun
美属萨摩亚群岛	transcribed toponym
中国宁波网	other proper noun
萨尔图	toponym
什维尔	toponym
盐水花生	noun
port_moresby	transcribed toponym
普罗维登斯	toponym
承德晚报	other proper noun
东南新闻网	other proper noun
san_marino	transcribed toponym
现代育儿报	other proper noun
温州网	other proper noun
中国车网	other proper noun
中央社新闻网	other proper noun
郾城区	toponym
苦瓜酿肉	noun
银州	toponym
武汉电视台	other proper noun
美属维尔京群岛	transcribed toponym
中国汽车商用网	other proper noun
易富网	other proper noun
姑苏晚报	other proper noun
中国品牌汽车网	other proper noun
Ireland	transcribed toponym
深圳生活网	other proper noun
燕赵车网	other proper noun
黄瓜炒鸡蛋	noun
首都建设报	other proper noun
Santo_Domingo	transcribed toponym
生物报	other proper noun
成武	toponym
Lesotho	transcribed toponym
accra	transcribed toponym
天极网	other proper noun
jakarta	transcribed toponym
华声在线	other proper noun
闽清	toponym
中国教育电视台	media	proper	noun
猪肝汤	noun
赤坎	toponym
Barbados	transcribed toponym
荆楚网	other proper noun
中证网	other proper noun
临武	toponym
中新社	other proper noun
青海电视台	other proper noun
中国水利报	other proper noun
楚雄日报	other proper noun
鱼香肉丝	noun
威海新闻网	other proper noun
黄河电视台	other proper noun
belmopan	transcribed toponym
潮南	toponym
新闻晨报	other proper noun
moroni	transcribed toponym
湖北日报	other proper noun
麻辣鸭脖	noun
武汉晨报	other proper noun
葱花饼	noun
肉末酸豆角	noun
麻章	toponym
赛迪网	other proper noun
油条	noun
深港在线	other proper noun
Noumea	transcribed toponym
中国电子商务协会	other proper noun
味增汤	noun
沈阳电视台	other proper noun
中国汽车在线	other proper noun
Kinshasa	transcribed toponym
Moscow	transcribed toponym
中国税务报	other proper noun
厦门汽车网	other proper noun
国防时报	other proper noun
sao_tome	transcribed toponym
华军软件园	other proper noun
江源区	toponym
中国经济通讯社CENS	other proper noun
剁椒鸡丁	noun
Jakarta	transcribed toponym
宝宝客育儿网	other proper noun
常德广播电视报	other proper noun
河南工人日报	other proper noun
Iran	transcribed toponym
青岛新闻网	other proper noun
double	noun
方便面	noun
湖北电视台	other proper noun
papeete	transcribed toponym
黔西南日报	other proper noun
civil	noun
福建日报	other proper noun
Valley	transcribed toponym
宜章	toponym
广东建设报	other proper noun
身体无优健康网	other proper noun
作家文摘报	other proper noun
瓜德罗普岛	transcribed toponym
华侨管理区	toponym
第三媒体	other proper noun
niamey	transcribed toponym
红烧鱼	noun
青椒炒肉丝	noun
闵行	toponym
车盟	other proper noun
宣武报	other proper noun
美属萨摩亚群岛	toponym
毛血旺	noun
广陵	toponym
把子肉	noun
印度联合新闻社	other proper noun
扬州汽车网	other proper noun
辽源	toponym
山东广播电台	other proper noun
相城	toponym
辽宁农民报	other proper noun
语文报	other proper noun
馒头	noun
哈尔滨电视台	other proper noun
1m1m健康网	other proper noun
moscow	transcribed toponym
太平洋家居网	other proper noun
Stockholm	transcribed toponym
port-of-spain	transcribed toponym
火奴鲁鲁	toponym
宁夏日报	other proper noun
四川新闻网	other proper noun
新疆日报网	other proper noun
滕州日报	other proper noun
ottawa	transcribed toponym
road_town	transcribed toponym
毛毛虫面包	noun
tramcar	noun
镇原	toponym
收藏拍卖导报	other proper noun
狮子山区	toponym
法属波利尼西亚	toponym
Zimbabwe	transcribed toponym
天键网	other proper noun
萝卜汤	noun
爆米花	noun
Jerusalem	transcribed toponym
北京卫视	other proper noun
新京报	other proper noun
濠江	toponym
海南热线	other proper noun
炸耦合	noun
Guadeloupe	transcribed toponym
colombo	transcribed toponym
盐阜大众报	other proper noun
延川	toponym
梵蒂冈城	transcribed toponym
红烧牛肉	noun
固安	toponym
独山	toponym
华讯网	other proper noun
新生晚报	other proper noun
身份卑微	adjective phrase
江南晚报	other proper noun
Montevideo	transcribed toponym
Niger	transcribed toponym
Bucharest	transcribed toponym
重庆热线	other proper noun
山西晚报	other proper noun
四川广播电台	other proper noun
北市	toponym
麦积区	toponym
浔阳	toponym
Kingstown	transcribed toponym
Palau	transcribed toponym
华侨晚报	other proper noun
哈里斯堡	transcribed toponym
苏式月饼	noun
朱巴	toponym
中国信息产业网	other proper noun
中华工商时报	other proper noun
瑞丽女性网	other proper noun
United_Arab_Emirates	transcribed toponym
非常在线网	other proper noun
班机	noun
晋安	toponym
时尚女性网	other proper noun
Mauritius	transcribed toponym
巳	numeral
东至	toponym
菠菜鸡蛋汤	noun
hanoi	transcribed toponym
贵池	toponym
艾媒网	other proper noun
国际在线	media	proper	noun
三杯鸡	noun
Swaziland	transcribed toponym
珠海特区报	other proper noun
Ivory_Coast	transcribed toponym
香港夜报	other proper noun
手抓饼	noun
拔丝地瓜	noun
山西日报	other proper noun
新林区	toponym
中国产业经济信息网	other proper noun
Kuwait	transcribed toponym
禅城	toponym
Yamoussoukro	transcribed toponym
三亚晨报	other proper noun
莎啦婚嫁网	other proper noun
羊城体育	other proper noun
阿布贾	toponym
sanaa	transcribed toponym
Roseau	transcribed toponym
深圳信息港	other proper noun
中国资金网	other proper noun
新民晚报	other proper noun
雅虎网	other proper noun
远安	toponym
垦利	toponym
牛肉酱	noun
copenhagen	transcribed toponym
东方健康网	other proper noun
韶关日报	other proper noun
蛋包饭	noun
中通社	other proper noun
阿皮亚	transcribed toponym
香椿鱼儿	noun
福建广播电台	other proper noun
特区青年报	other proper noun
美新报	other proper noun
河北卫视	other proper noun
禹王台区	toponym
阿里	organization/group name
四川政协报	other proper noun
糖醋排骨	noun
衢江	toponym
机锋网	other proper noun
驱动之家	other proper noun
兰山	toponym
福布斯中文网	other proper noun
中国冶金报	other proper noun
中国青年网	other proper noun
河北之窗	other proper noun
Romania	transcribed toponym
中财网	other proper noun
大公报	other proper noun
Valletta	transcribed toponym
微山	toponym
镇海区	toponym
百色早报	other proper noun
广东电视台	other proper noun
泉港	toponym
湄州日报	other proper noun
巴音郭楞	toponym
Tonga	transcribed toponym
Haiti	transcribed toponym
射洪	toponym
清蒸鲈鱼	noun
可乐饼	noun
Sofia	transcribed toponym
Libreville	transcribed toponym
酸梅汤	noun
大盘鸡	noun
集邮报	other proper noun
好育园网	other proper noun
Bamako	transcribed toponym
Plymouth	transcribed toponym
环球时报	other proper noun
brazzaville	transcribed toponym
国际在线	other proper noun
河南农村报	other proper noun
酸辣白菜	noun
21世纪体育报	other proper noun
顶尖财经网	other proper noun
双江拉祜族佤族布朗族傣族自治县	toponym
白灼芥蓝	noun
airplane	noun
大英	toponym
虎皮凤爪	noun
Madrid	transcribed toponym
55BBS	other proper noun
中国石油报	other proper noun
上海热线	other proper noun
泰州晚报	other proper noun
宾夕法尼亚	toponym
计世网	other proper noun
london	transcribed toponym
蚌山	toponym
自制凉皮	noun
san_jose	transcribed toponym
产后女性网	other proper noun
辽宁老年报	other proper noun
长江网	other proper noun
prague	transcribed toponym
南通网	other proper noun
团城山开发区	toponym
卓众汽车网	other proper noun
拱墅	toponym
腾冲	toponym
解放军报	other proper noun
西部金融报	other proper noun
Saipan	transcribed toponym
Hanoi	transcribed toponym
中国金融网	other proper noun
玄武	toponym
乌恰	toponym
采风报	other proper noun
龙虎网	other proper noun
中国教育在线	other proper noun
新疆新闻在线	other proper noun
东南网	other proper noun
电子时报	other proper noun
Unewspaper	proper	nouna	transcribed toponym
舞台与银幕	other proper noun
中国乡镇企业报	other proper noun
中国旅游报	other proper noun
中金在线	other proper noun
凤凰卫视	media	proper	noun
手撕杏鲍菇	noun
赫章	toponym
秋梨膏	noun
中国汽车新网	other proper noun
会昌	toponym
上海家庭报	other proper noun
马芬	noun
波多黎各岛	transcribed toponym
颍东	toponym
茂港	toponym
turbofan	noun
江津区	toponym
每日经济新闻	other proper noun
白云鄂博矿区	toponym
圣文森特岛	transcribed toponym
计算机世界	other proper noun
lifeboat	noun
other proper noun'djamena	transcribed toponym
甘井子	toponym
中国中医药报	other proper noun
葱爆羊肉	noun
上海法治报	other proper noun
大连晚报	other proper noun
seoul	transcribed toponym
大柴旦	toponym
中国经济导报	other proper noun
车世界	other proper noun
金融投资报	other proper noun
Guyana	transcribed toponym
襄汾	toponym
中国时尚在线	other proper noun
花花女性网	other proper noun
昭通日报	other proper noun
上海金融报	other proper noun
manama	transcribed toponym
成华	toponym
文摘报	other proper noun
第一车网	other proper noun
plymouth	transcribed toponym
三峡晚报	other proper noun
四物汤	noun
普洱市	toponym
嵩明	toponym
南湖区	toponym
今日消费	other proper noun
将军报	other proper noun
至顶网	other proper noun
都市汽车网	other proper noun
plane	noun
海原	toponym
阳春面	noun
streetcar	noun
阿加尼亚	transcribed toponym
乌什	toponym
tunis	transcribed toponym
舜网	other proper noun
武鸣	toponym
麻团	noun
网络新闻	other proper noun
东丰	toponym
Algeria	transcribed toponym
Managua	transcribed toponym
江苏广播电台	other proper noun
天府热线网	other proper noun
巴音郭楞日报	other proper noun
黔西南	toponym
黑龙江电视台	other proper noun
江海晚报	other proper noun
榆中	toponym
北京热线	other proper noun
学生导报	other proper noun
塔拉哈西	toponym
肉龙	noun
浙中科技报	other proper noun
宫保虾球	noun
安道尔城	toponym
云浮日报	other proper noun
英文虎报	other proper noun
Vienna	transcribed toponym
Ecuador	transcribed toponym
浉河区	toponym
华容	toponym
Lilongwe	transcribed toponym
茂名侨报	other proper noun
浏阳日报	other proper noun
行报	other proper noun
宁洱哈尼族彝族自治县	toponym
牛肉汤	noun
太平洋汽车报价	other proper noun
莱芜日报	other proper noun
北方晨报	other proper noun
东方日报	other proper noun
san_salvador	transcribed toponym
医网中国	other proper noun
四川税务报	other proper noun
宝贝岛育儿网	other proper noun
柏乡	toponym
枫溪区	toponym
San_Salvador	transcribed toponym
巴吞鲁日	toponym
秦州区	toponym
中国孕育网	other proper noun
青椒炒鸡蛋	noun
重庆经济报	other proper noun
山东邮电报	other proper noun
北京理工大学	organization/group name
电白	toponym
子长	toponym
荷塘小炒	noun
中国时尚品牌网	other proper noun
和讯网	other proper noun
乾安	toponym
Spain	transcribed toponym
锅贴	noun
共同社	other proper noun
镇安	toponym
Pakistan	transcribed toponym
安徽广播电台	other proper noun
文摘周刊	other proper noun
亲亲宝贝网	other proper noun
深圳新闻网	other proper noun
nassau	transcribed toponym
奢侈网	other proper noun
兰州晚报	other proper noun
田纳西	toponym
Bern	transcribed toponym
荷叶饼	noun
品牌中国网	other proper noun
Rwanda	transcribed toponym
Nairobi	transcribed toponym
洛阳日报	other proper noun
深圳都市报	other proper noun
门头沟	toponym
人民政协报	other proper noun
头条日报	other proper noun
中国吉林网	other proper noun
鸡东	toponym
丛台	toponym
太子河	toponym
南芬	toponym
牛肉干	noun
无线电视台	media	proper	noun
汤旺河	toponym
车前线	other proper noun
Windhoek	transcribed toponym
安居客	other proper noun
辣椒油	noun
汕头第一网	other proper noun
nuku'alofa	transcribed toponym
南阳晚报	other proper noun
广安日报	other proper noun
贵州日报	other proper noun
中国消费者报	other proper noun
China	transcribed toponym
承德日报	other proper noun
中国家电网	other proper noun
炸菠菜脯	noun
杭州网	other proper noun
父母网	other proper noun
Georgetown	transcribed toponym
艾瑞	organization/group name
东南快报	other proper noun
Greenland	transcribed toponym
39健康网	other proper noun
波德戈里察	transcribed toponym
经济日报	other proper noun
时尚网	other proper noun
滕州	toponym
中华网	other proper noun
太原日报	other proper noun
联合报	other proper noun
云南卫视	other proper noun
好宝贝育儿网	other proper noun
盐亭	toponym
宿迁晚报	other proper noun
Nigeria	transcribed toponym
lome	transcribed toponym
黄河新闻网	other proper noun
Astana	transcribed toponym
阳江视窗	other proper noun
宝宝妈妈网	other proper noun
合肥晚报	other proper noun
湖南经济新闻网	other proper noun
浙江电视台	other proper noun
市南区	toponym
镇平	toponym
里士满	toponym
关东煮	noun
电子电脑报	other proper noun
e-works	other proper noun
中国民航报	other proper noun
Port_Louis	transcribed toponym
中安网	other proper noun
Thailand	transcribed toponym
san_juan	transcribed toponym
青秀区	toponym
athens	transcribed toponym
任丘	toponym
warsaw	transcribed toponym
小石城	toponym
subway	noun
俄新社	other proper noun
俾斯麦	toponym
美联社	other proper noun
浙江工人日报	other proper noun
amsterdam	transcribed toponym
英语周报	other proper noun
夷陵	toponym
上海家居网	other proper noun
英属维尔京群岛	toponym
金融界	other proper noun
大众日报	other proper noun
济南广播电台	other proper noun
维扬区	toponym
翔安	toponym
波斯尼亚和黑塞哥维那	transcribed toponym
江西卫视	other proper noun
时尚汽车网	other proper noun
寿司	noun
airliner	noun
今晚网	other proper noun
巨野	toponym
南京热线	other proper noun
上海中学生报	other proper noun
valletta	transcribed toponym
西弗吉尼亚	toponym
意大利面	noun
讽刺与幽默	other proper noun
杏仁豆腐	noun
中国名车网	other proper noun
源汇	toponym
中国品牌网	other proper noun
妈妈说	other proper noun
视周刊	other proper noun
老年日报	other proper noun
中国企业报	other proper noun
齐鲁都市网	other proper noun
香辣蟹	noun
重庆时报	other proper noun
脆皮炸鲜奶	noun
金寨	toponym
仓山	toponym
忧患精神	noun phrase
saint_john's	transcribed toponym
摇篮网	other proper noun
炖鸡	noun
麻辣千张	noun
健康文摘报	other proper noun
汇优妈妈网	other proper noun
Saint-Denis	transcribed toponym
鲫鱼汤	noun
阿坝日报	other proper noun
民众健康网	other proper noun
米内网	other proper noun
耿马	toponym
金陵晚报	other proper noun
点心卫视	media	proper	noun
亚洲经济通讯社	other proper noun
Greece	transcribed toponym
饺子	noun
石油管道报	other proper noun
大列巴	noun
北塔	toponym
信息时报	other proper noun
昆都仑	toponym
七丽女性网	other proper noun
望奎	toponym
贾汪	toponym
Estonia	transcribed toponym
河源晚报	other proper noun
苏州汽车网	other proper noun
楚雄彝族自治州	toponym
中国车展信息网	other proper noun
酥饼	noun
松仁玉米	noun
Morocco	transcribed toponym
羊城晚报	other proper noun
Rome	transcribed toponym
IT世界网	other proper noun
湖南红网	other proper noun
华东旅游报	other proper noun
北方时报	other proper noun
红焖羊肉	noun
Porto-Novo	transcribed toponym
冕宁	toponym
寻医问药网	other proper noun
蚂蚁上树	noun
莱城	toponym
猇亭区	toponym
科技导报	other proper noun
生活周报	other proper noun
天天商报	other proper noun
红烧茄子	noun
金华日报	other proper noun
北碚	toponym
半岛晨报	other proper noun
柳州新闻网	other proper noun
南华早报	other proper noun
自制酸奶	noun
赛肘花	noun
passenger	noun
洮北	toponym
新喀里多尼亚	transcribed toponym
渤海早报	other proper noun
今晚报	other proper noun
人民公安报	other proper noun
每周文摘	other proper noun
乡城	toponym
海南广播电台	other proper noun
四方台	toponym
呼兰区	toponym
冬瓜排骨汤	noun
都市日报	other proper noun
中国财经信息网	other proper noun
bern	transcribed toponym
科学时报	other proper noun
保定在线	other proper noun
今日早报	other proper noun
乳源	toponym
芹菜炒香干	noun
车马驿站	other proper noun
海陵	toponym
Port-Au-Prince	transcribed toponym
健康时报	other proper noun
海南声屏报	other proper noun
山东教育卫视	other proper noun
湖南广播电台	other proper noun
淮安晚报	other proper noun
中国安防网	other proper noun
中山网	other proper noun
金华晚报	other proper noun
淇滨	toponym
涡轮螺旋桨飞机	noun
Niamey	transcribed toponym
红花岗	toponym
大江晚报	other proper noun
河北法制报	other proper noun
中国女性网	other proper noun
公共汽车	noun
麦肯锡	organization/group name
桂阳	toponym
秦都	toponym
Riyadh	transcribed toponym
亚马逊	organization/group name
Malabo	transcribed toponym
中国化妆品网	other proper noun
阳原	toponym
budapest	transcribed toponym
Czech_Republic	transcribed toponym
贵州商报	other proper noun
清蒸大闸蟹	noun
合众国际社	other proper noun
熘肝尖	noun
合肥在线	other proper noun
basseterre	transcribed toponym
Brazil	transcribed toponym
东方财富网	other proper noun
板栗烧鸡	noun
今日女报	other proper noun
新疆广播电台	other proper noun
Tirana	transcribed toponym
宁波广播电台	other proper noun
兵团卫视	other proper noun
中国财富网	other proper noun
鲅鱼圈	toponym
花溪	toponym
台湾新闻报	other proper noun
姚安	toponym
中国电力报	other proper noun
东方体育报	other proper noun
Manila	transcribed toponym
凤凰网	other proper noun
奥尔良烤翅	noun
三峡都市报	other proper noun
安道尔城	transcribed toponym
柯城	toponym
房地产时报	other proper noun
炒年糕	noun
中国消费网	other proper noun
热血时报	other proper noun
北方网	other proper noun
黑龙江经济报	other proper noun
云城	toponym
旌阳	toponym
东方少年	other proper noun
平房区	toponym
八公山	toponym
木垒	toponym
舟山日报	other proper noun
Jamaica	transcribed toponym
农村大众	other proper noun
松鼠鱼	noun
人民报	other proper noun
淄博日报	other proper noun
麻辣肉片	noun
疙瘩汤	noun
定结	toponym
走进中关村	other proper noun
西弗吉尼亚	transcribed toponym
昆明信息港	other proper noun
谷歌	organization/group name
yaounde	transcribed toponym
雁塔	toponym
菏泽日报	other proper noun
中学时事报	other proper noun
长春	other proper noun
bucharest	transcribed toponym
中学生报	other proper noun
路透社	media	proper	noun
奇艺	organization/group name
中国钟表网	other proper noun
南京广播电台	other proper noun
铜官山	toponym
锅塌豆腐	noun
奎屯	toponym
珍珠圆子	noun
台湾教会公报	other proper noun
北京青年报	other proper noun
东北乱炖	noun
内蒙古卫视	other proper noun
Warsaw	transcribed toponym
奥一网	other proper noun
德新社	other proper noun
中国地产信息网	other proper noun
江苏工人报	other proper noun
中央电视台	media	proper	noun
双层公共汽车	noun
中国少年报	other proper noun
云南信息港	other proper noun
邯山	toponym
自来红	noun
加格达奇区	toponym
19楼	other proper noun
五通桥	toponym
溪湖	toponym
郑州日报	other proper noun
茄汁带鱼	noun
东辽	toponym
六盘水日报	other proper noun
中国保险报	other proper noun
七星	toponym
宿豫区	toponym
亚洲华尔街日报	other proper noun
海峡消费报	other proper noun
彝良	toponym
支点网	other proper noun
芝士面包	noun
琅琊	toponym
山东卫视	other proper noun
北京新娘网	other proper noun
hovercraft	noun
Cape_Verde	transcribed toponym
原州	toponym
苏州广播电视报	other proper noun
新车评网	other proper noun
叙永	toponym
武胜	toponym
芜湖日报	other proper noun
Germany	transcribed toponym
CBI	News
埃菲社	other proper noun
科学生活报	other proper noun
尼木	toponym
都市客网	other proper noun
饭团	noun
东南商报	other proper noun
广西日报	other proper noun
双皮奶	noun
绍兴日报	other proper noun
云南新闻网	other proper noun
红烧肉	noun
万车网	other proper noun
中原网	other proper noun
叉烧肉	noun
晋源	toponym
荆门日报	other proper noun
固阳	toponym
Liechtenstein	transcribed toponym
阜康	toponym
四川卫视	other proper noun
易车网	other proper noun
瓜德罗普岛	toponym
Luxembourg	transcribed toponym
辽一网	other proper noun
中国婴童网	other proper noun
潇湘晨报	other proper noun
麻辣豆腐	noun
saint-denis	transcribed toponym
内蒙古电视台	other proper noun
渝中	toponym
东方亲子网	other proper noun
瑶海	toponym
旱溪地区报	other proper noun
吴中	toponym
波多诺夫	transcribed toponym
茂南	toponym
akmola	transcribed toponym
charlotte_amalie	transcribed toponym
重庆卫视	other proper noun
Grand_Turk	transcribed toponym
燕赵车网	other proper noun
TechWeb	other proper noun
鸡泽	toponym
娄底新闻网	other proper noun
晴报	other proper noun
尼勒克	toponym
糖不甩	noun
越西	toponym
韭菜炒鱿鱼	noun
济南日报	other proper noun
拉美社	other proper noun
华娱卫视	media	proper	noun
体坛周报	other proper noun
YAHOO网	other proper noun
齐河	toponym
中国证券网	other proper noun
更生日报	other proper noun
计程汽车	noun
四川在线	other proper noun
现代快报	other proper noun
康巴卫视	other proper noun
周口日报	other proper noun
网易	other proper noun
Adamstown	transcribed toponym
今晨6点	other proper noun
甘肃新闻网	other proper noun
南阳	toponym
延吉晚报	other proper noun
四川法制报	other proper noun
快报	other proper noun
尼克西亚	transcribed toponym
银耳莲子汤	noun
lima	transcribed toponym
南方健康网	other proper noun
仙游	toponym
甲	numeral
京酱肉丝	noun
爱奇艺	organization/group name
Reykjavik	transcribed toponym
会理	toponym
中国证卷网	other proper noun
大竹	toponym
中国母亲网	other proper noun
巴州	toponym
肉饼蒸蛋	noun
河北工人报	other proper noun
mbabane	transcribed toponym
城市商报	other proper noun
法新社	media	proper	noun
潘集	toponym
嘉人网	other proper noun
Lome	transcribed toponym
washington,_dc	transcribed toponym
尖椒土豆片	noun
kinshasa	transcribed toponym
甘肃农民报	other proper noun
香港经济日报	other proper noun
元阳	toponym
富蕴	toponym
江苏法制报	other proper noun
怀俄明	transcribed toponym
深圳卫视	other proper noun
中学生时事政治	other proper noun
月湖	toponym
生活报	other proper noun
元宝山	toponym
冰激凌	noun
巴斯特尔	toponym
other proper noun._Mariana_Islands	transcribed toponym
Ukraine	transcribed toponym
南卡罗来纳	transcribed toponym
中国交通报	other proper noun
家天下网	other proper noun
四方报	other proper noun
威斯康星	transcribed toponym
江南都市报	other proper noun
无棣	toponym
苏州日报	other proper noun
Papua_New_Guinea	transcribed toponym
bridgetown	transcribed toponym
Paramaribo	transcribed toponym
海勃湾	toponym
金城江	toponym
披萨	noun
农林卫视	other proper noun
雅江	toponym
安徽汽车网	other proper noun
人民网广东	other proper noun
Zambia	transcribed toponym
南京电视台	other proper noun
大连电视台	other proper noun
街市报	other proper noun
Western_Sahara	transcribed toponym
kampala	transcribed toponym
basse-terre	transcribed toponym
大河文摘报	other proper noun
靖州	toponym
Nauru	transcribed toponym
广西电视台	other proper noun
CSDN	other proper noun
汽车探索	other proper noun
清远市信息网	other proper noun
措美	toponym
gaborone	transcribed toponym
涟源	toponym
农村新报	other proper noun
田东	toponym
湖北广播电台	other proper noun
宿迁日报	other proper noun
Tajikistan	transcribed toponym
湛江日报	other proper noun
汽车之友	other proper noun
汕头特区晚报	other proper noun
中小企业IT网	other proper noun
龙井虾仁	noun
中国集邮报	other proper noun
糖渍金桔	noun
madrid	transcribed toponym
经济导报	other proper noun
利州区	toponym
湛江晚报	other proper noun
singapore	transcribed toponym
花卷	noun
内比都	toponym
montevideo	transcribed toponym
东昌府	toponym
内蒙古广播电台	other proper noun
Vietnam	transcribed toponym
buenos_aires	transcribed toponym
江淮晨报	other proper noun
泰安日报	other proper noun
河南日报	other proper noun
中国纺织报	other proper noun
手机中国	other proper noun
密克罗尼西亚联邦	transcribed toponym
林周	toponym
青岛汽车网	other proper noun
麻婆豆腐	noun
河南商报	other proper noun
PChome	other proper noun
郴州在线	other proper noun
光明日报	other proper noun
钦北	toponym
Dar_Es_Salaam	transcribed toponym
游船	noun
网民	noun
Portugal	transcribed toponym
中国家电在线	other proper noun
abuja	transcribed toponym
定边	toponym
东亚经贸新闻	other proper noun
深圳在线	other proper noun
老年生活报	other proper noun
自由新闻报	other proper noun
双滦	toponym
厦门卫视	other proper noun
台中日报	other proper noun
鸠江	toponym
Ljubljana	transcribed toponym
加尔福尼亚	transcribed toponym
宽甸	toponym
元谋	toponym
足球周报	other proper noun
云南车网	other proper noun
特克斯群岛和凯科斯群岛	transcribed toponym
金明区	toponym
中国文化报	other proper noun
岚山区	toponym
乌鸡汤	noun
徽县	toponym
Jordan	transcribed toponym
dar_es_salaam	transcribed toponym
海晏	toponym
自制剁椒	noun
中国报目报	other proper noun
瓜州县	toponym
Malaysia	transcribed toponym
信丰	toponym
南方日报	other proper noun
Micronesia	transcribed toponym
龙岗	toponym
烧卖	noun
电脑商情报	other proper noun
王石	personal	name
华夏时报网站	other proper noun
乳酪蛋糕	noun
Turkmenistan	transcribed toponym
南昌日报	other proper noun
银海	toponym
司康	noun
Port-Of-Spain	transcribed toponym
麻辣香锅	noun
Paraguay	transcribed toponym
虎皮青椒	noun
台湾立报	other proper noun
兰州晨报	other proper noun
世界经理人	other proper noun
四川日报	other proper noun
rabat	transcribed toponym
豆腐脑	noun
中国商用汽车网	other proper noun
骨头汤	noun
梅江	toponym
植物大战僵尸	software	proper	noun
21世纪网	other proper noun
Wellington	transcribed toponym
桂林生活网	other proper noun
船山	toponym
吉林日报	other proper noun
塞拉里昂	transcribed toponym
扶沟	toponym
今早报	other proper noun
高端财经	other proper noun
西部商报	other proper noun
好报	other proper noun
央视网	other proper noun
美属维尔京群岛	toponym
Nouakchott	transcribed toponym
牛肉面	noun
奎文	toponym
普腊亚	transcribed toponym
布朗尼	noun
今日商报	other proper noun
南浔	toponym
Fiji	transcribed toponym
沾益	toponym
sailing	noun
肉皮冻	noun
帕劳	transcribed toponym
梅州视窗	other proper noun
中国日报香港版	other proper noun
自制豆腐	noun
三山区	toponym
algiers	transcribed toponym
梅菜扣肉	noun
蚌山区	toponym
中国儿童报	other proper noun
London	transcribed toponym
Havana	transcribed toponym
深圳晚报	other proper noun
蛋炒饭	noun
安徽卫视	other proper noun
凉山日报	other proper noun
出租汽车	noun
青岛画报	other proper noun
潮汕少年周刊	other proper noun
蒜泥白肉	noun
锦州晚报	other proper noun
Santiago	transcribed toponym
木耳炒肉	noun
凤泉	toponym
雁江	toponym
东阿	toponym
Koror	transcribed toponym
taxicab	noun
火车	noun
薛城	toponym
Kathmandu	transcribed toponym
安次	toponym
宣威	toponym
广西市场报	other proper noun
延平	toponym
第一财经网	other proper noun
肉夹馍	noun
安徽热线	other proper noun
Albania	transcribed toponym
汽车中国	other proper noun
几内亚比绍共和国	transcribed toponym
爱卡汽车网	other proper noun
Denmark	transcribed toponym
巨报	other proper noun
女人志	other proper noun
太平洋女性网	other proper noun
中央人民广播电台	media	proper	noun
临湘	toponym
潍城	toponym
喷气机	noun
好太太网	other proper noun
中共代表团	organization/group name
海口晚报	other proper noun
Maldives	transcribed toponym
时空网	other proper noun
浙江在线	other proper noun
无轨电车	noun
长春车市网	other proper noun
新抚	toponym
中国汽车资源网	other proper noun
挖贝网	other proper noun
新闻周刊	other proper noun
Rabat	transcribed toponym
太平洋电脑网	other proper noun
无锡汽车网	other proper noun
酱油炒饭	noun
六盘水晚报	other proper noun
冰糖炖雪梨	noun
中国信息服务网	other proper noun
爱贝贝网	other proper noun
Aananarivo	transcribed toponym
咖喱饭	noun
岗巴	toponym
山东电视台	other proper noun
长江日报	other proper noun
大连开发区报	other proper noun
中国经济新闻网	other proper noun
思茅区	toponym
主妇网	other proper noun
黑龙江工人报	other proper noun
酸菜鱼	noun
硚口区	toponym
休宁	toponym
重庆广播电台	other proper noun
高德	organization/group name
惠济区	toponym
西藏电视台	other proper noun
新文化报	other proper noun
广东卫视	other proper noun
鞍山日报	other proper noun
东光	toponym
武汉热线	other proper noun
元氏	toponym
Teheran	transcribed toponym
红烧鸡爪	noun
春卷	noun
温州新闻网	other proper noun
国防知识报	other proper noun
黑森林蛋糕	noun
Athens	transcribed toponym
南京日报	other proper noun
快乐妈妈网	other proper noun
蒜薹炒肉	noun
San_Jose	transcribed toponym
Riga	transcribed toponym
环球网	other proper noun
khartoum	transcribed toponym
红海湾	toponym
健康报网	other proper noun
盐水鸭	noun
上校鸡块	noun
科林	organization/group name
yamoussoukro	transcribed toponym
糖醋鱼	noun
noumea	transcribed toponym
Anguilla	transcribed toponym
香港有线电视	media	proper	noun
剁椒鱼头	noun
ELLE中国网	other proper noun
阿加尼亚	toponym
地方报社	other proper noun
津南	toponym
田纳西	transcribed toponym
夏延	toponym
七里河	toponym
法制日报	other proper noun
西红柿炒鸡蛋	noun
Zagreb	transcribed toponym
georgetown	transcribed toponym
中国环境报	other proper noun
艾窝窝	noun
Guam	transcribed toponym
肇庆都市报道	other proper noun
澳联社	other proper noun
long-haul	noun
西北信息报	other proper noun
神农架林区	toponym
莎车	toponym
asuncion	transcribed toponym
香辣酥	noun
汽车画报网	other proper noun
武平	toponym
车评网	other proper noun
河源	toponym
Manama	transcribed toponym
浙江新闻网	other proper noun
上海信息港	other proper noun
东北网	other proper noun
中国汽车服务网	other proper noun
珠江晚报	other proper noun
沙坪坝	toponym
北仑	toponym
精品购物指南	other proper noun
海峡都市报	other proper noun
西藏卫视	other proper noun
南郊区	toponym
中程飞机	noun
鹰潭	toponym
Toshkent	transcribed toponym
海峡导报	other proper noun
绩溪	toponym
Congo_Rep.	transcribed toponym
turbojet	noun
西芹百合	noun
中国汽车商务网	other proper noun
成都商报	other proper noun
定海	toponym
凉面	noun
青岛早报	other proper noun
习水	toponym
南宁新闻网	other proper noun
钦南	toponym
咸宁日报	other proper noun
yacht	noun
品周报	other proper noun
健康报	other proper noun
苹果日报	other proper noun
镇远	toponym
大河网	other proper noun
曾都	toponym
中国质量报	other proper noun
东昌	toponym
九龙坡	toponym
小学生报	other proper noun
苏打饼干	noun
临沂日报	other proper noun
马萨诸塞	transcribed toponym
Maseru	transcribed toponym
江南保健报	other proper noun
边坝	toponym
蓝筹财经网	other proper noun
浙江热线	other proper noun
帆船	noun
成安	toponym
Sanaa	transcribed toponym
郴州新闻网	other proper noun
宁夏电视台	other proper noun
科威特城	toponym
广州在线	other proper noun
名品网	other proper noun
铜山区	toponym
谢家集	toponym
Brazzaville	transcribed toponym
Costa_Rica	transcribed toponym
慈利	toponym
工人时报	other proper noun
Buenos	Aires	transcribed toponym
Colombo	transcribed toponym
河南电视台	other proper noun
富帅	noun
浙江老年报	other proper noun
The_Gambia	transcribed toponym
信息参考报	other proper noun
蒸湘	toponym
bus	noun
Turkey	transcribed toponym
上海视窗	other proper noun
天主教周报	other proper noun
文三街在线	other proper noun
Iceland	transcribed toponym
星空传媒	media	proper	noun
钦州日报	other proper noun
京郊日报	other proper noun
广东新闻网	other proper noun
Vaduz	transcribed toponym
51CTO	other proper noun
Amman	transcribed toponym
杭州电视台	other proper noun
江苏新闻网	other proper noun
广西新闻网	other proper noun
蚌埠日报	other proper noun
vaduz	transcribed toponym
辽西商报	other proper noun
Brasilia	transcribed toponym
山西商报	other proper noun
西江日报	other proper noun
河南广播电台	other proper noun
北方热线	other proper noun
Botswana	transcribed toponym
万柏林	toponym
阳山	toponym
山西电视台	other proper noun
Islamabad	transcribed toponym
胶州湾信息港	other proper noun
阳光卫视	media	proper	noun
哈伯罗内	transcribed toponym
Berlin	transcribed toponym
大成报	other proper noun
每日新报	other proper noun
蓬莱日报	other proper noun
薯片	noun
重庆广播电视报	other proper noun
丁青	toponym
江西新闻网	other proper noun
留尼旺岛	toponym
杂文报	other proper noun
九江日报	other proper noun
乐山日报	other proper noun
南瓜饼	noun
圣但尼	transcribed toponym
厦门日报	other proper noun
Angola	transcribed toponym
重庆电视台	other proper noun
通信产业网	other proper noun
80后之窗	other proper noun
沿滩	toponym
中宁	toponym
北海日报	other proper noun
唐海	toponym
Port_Moresby	transcribed toponym
上海商报	other proper noun
奶香馒头	noun
Rangoon	transcribed toponym
芜湖新闻网	other proper noun
旬邑	toponym
茄子河	toponym
圣但尼	toponym
雅安日报	other proper noun
T'bilisi	transcribed toponym
枣庄日报	other proper noun
驿城	toponym
Herschina	other proper noun
周鸿祎	personal	name
捷克斯洛伐克共和国	transcribed toponym
Tripoli	transcribed toponym
环球母婴网	other proper noun
派	noun
沈河	toponym
Abuja	transcribed toponym
中国经济网	other proper noun
上海新闻网	other proper noun
中国云计算	other proper noun
辣椒酱	noun
波哥达	transcribed toponym
中国国防报	other proper noun
圣约瑟	transcribed toponym
Addis_Ababa	transcribed toponym
doha	transcribed toponym
西双版纳报	other proper noun
哈尔滨资讯网	other proper noun
coach	noun
中国育婴网	other proper noun
解构	noun-verb
易特网	other proper noun
商学院	other proper noun
浈江	toponym
kingstown	transcribed toponym
北国网	other proper noun
江门日报	other proper noun
Asmara	transcribed toponym
鹰手营子矿区	toponym
云南广播电台	other proper noun
青椒土豆丝	noun
kigali	transcribed toponym
phnom_penh	transcribed toponym
南昌商报	other proper noun
阿尔卡特	organization/group name
爽报	other proper noun
无锡日报	other proper noun
西南铁道报	other proper noun
西南商报	other proper noun
中安在线	other proper noun
IT专家网	other proper noun
中国老年网	other proper noun
天峨	toponym
luxembourg	transcribed toponym
红烧狮子头	noun
安塔拉	other proper noun
申报	other proper noun
havana	transcribed toponym
沈阳晚报	other proper noun
捷克斯洛伐克共和国	toponym
东方快报	other proper noun
四川泡菜	noun
成龙汽车网	other proper noun
长城网	other proper noun
华商报	other proper noun
武乡	toponym
沙拉	noun
文摘周报	other proper noun
Bagdad	transcribed toponym
二道江	toponym
萧山日报	other proper noun
喷气飞机	noun
深圳商报	other proper noun
尖草坪	toponym
南谯	toponym
Monrovia	transcribed toponym
凉拌黑木耳	noun
兴庆	toponym
Paris	transcribed toponym
Equatorial_Guinea	transcribed toponym
腾讯大渝网	other proper noun
中国软件资讯网	other proper noun
忻城	toponym
手撕包菜	noun
甘州	toponym
晚晴报	other proper noun
上海星期三	other proper noun
万州日报	other proper noun
安康家园	other proper noun
南区新闻	other proper noun
平顶山晚报	other proper noun
椒盐虾	noun
珍珠丸子	noun
Victoria	transcribed toponym
京华网	other proper noun
沁阳	toponym
现代女报	other proper noun
燕赵都市报	other proper noun
菲尼克斯	toponym
海林	toponym
铁板鱿鱼	noun
tripoli	transcribed toponym
Conakry	transcribed toponym
唐河	toponym
济源日报	other proper noun
武汉广播电台	other proper noun
underground	noun
中网资讯网	other proper noun
新华社	other proper noun
Luanda	transcribed toponym
Croatia	transcribed toponym
常州车网	other proper noun
大众财经网	other proper noun
贵州都市报	other proper noun
电车	noun
Kazakhstan	transcribed toponym
四川科技报	other proper noun
汽车之家	other proper noun
闽东日报	other proper noun
中国汽车报	other proper noun
乌马河	toponym
自由时报	other proper noun
云南经济日报	other proper noun
Norway	transcribed toponym
富拉尔基	toponym
铁山港	toponym
清远日报	other proper noun
宫保豆腐	noun
Godthab	transcribed toponym
搜房网	other proper noun
左云	toponym
土豆炖牛肉	noun
三峡宜昌网	other proper noun
随县	toponym
珠山	toponym
La_Paz	transcribed toponym
荆州日报	other proper noun
咖喱牛肉	noun
秀屿	toponym
林甸	toponym
铜锣烧	noun
安提瓜岛	transcribed toponym
红烧冬瓜	noun
北京现代商报	other proper noun
农家小炒肉	noun
余江	toponym
蛋挞	noun
云和	toponym
电视日报	other proper noun
Puerto_Rico	transcribed toponym
Kenya	transcribed toponym
米东区	toponym
荆门晚报	other proper noun
修水	toponym
经济视点报	other proper noun
reykjavik	transcribed toponym
浔阳晚报	other proper noun
花垣	toponym
济南电视台	other proper noun
华亭	toponym
Japan	transcribed toponym
Oslo	transcribed toponym
第一亲子网	other proper noun
南达科他	transcribed toponym
丫丫网	other proper noun
Burma	transcribed toponym
迭部	toponym
ankara	transcribed toponym
Kuala_Lumpur	transcribed toponym
saint_george's	transcribed toponym
金融时报	other proper noun
广州广播电台	other proper noun
猫扑网	other proper noun
宁波侨讯	other proper noun
辽宁日报	other proper noun
深圳电视台	other proper noun
啤酒鸭	noun
西畴	toponym
英文公教报	other proper noun
科威特城	transcribed toponym
西沙群岛	toponym
zagreb	transcribed toponym
淄博晚报	other proper noun
甘肃广播电台	other proper noun
贵州电视台	other proper noun
招生考试报	other proper noun
Damascus	transcribed toponym
经济观察在线	other proper noun
浙江都市网	other proper noun
中国经济时报	other proper noun
抚松	toponym
塘沽区	toponym
Austria	transcribed toponym
阿布贾	transcribed toponym
四川电视台	other proper noun
中国广播网	other proper noun
丘北	toponym
阿里巴巴	organization/group name
薄荷女人网	other proper noun
甜甜圈	noun
大纪元时报	other proper noun
手指饼干	noun
Argentina	transcribed toponym
United_Kingdom	transcribed toponym
中国健康网	other proper noun
北京在线	other proper noun
Asuncion	transcribed toponym
I时代报	other proper noun
tirana	transcribed toponym
忻府	toponym
海峡生活报	other proper noun
齐家网	other proper noun
Sao_Tome	transcribed toponym
家庭教育导报	other proper noun
陈仓	toponym
人才市场报	other proper noun
察布查尔锡伯	toponym
中国煤炭报	other proper noun
Mexico	transcribed toponym
瑞丽家居网	other proper noun
大同晚报	other proper noun
丁丁网	other proper noun
中国电脑教育报	other proper noun
成都广播电台	other proper noun
武冈	toponym
杂多	toponym
胶州信息港	other proper noun
雷克亚未克	transcribed toponym
新华社	media	proper	noun
奥杰汽车网	other proper noun
城市晚报	other proper noun
Hagatna_(Agana)	transcribed toponym
芒果布丁	noun
阳西	toponym
青海卫视	other proper noun
nairobi	transcribed toponym
楚州	toponym
措勤	toponym
中国信息报	other proper noun
中国日报	other proper noun
addis_ababa	transcribed toponym
梅州日报	other proper noun
开封日报	other proper noun
Poland	transcribed toponym
扬子晚报	other proper noun
菲律宾共和国	transcribed toponym
周宁	toponym
la_paz	transcribed toponym
汕尾招商网	other proper noun
木瓜椰奶冻	noun
嘉兴日报	other proper noun
彭城晚报	other proper noun
天府早报	other proper noun
克东	toponym
quito	transcribed toponym
St._Vinceorganization/group name_And_The_Grenadines	transcribed toponym
蓝网	other proper noun
汕头日报	other proper noun
盐水虾	noun
泡芙	noun
Gibraltar	transcribed toponym
maputo	transcribed toponym
国际文传电讯社	other proper noun
家庭与生活报	other proper noun
芝心虾球	noun
澜沧	toponym
泡泡网	other proper noun
湖南科技报	other proper noun
呼中区	toponym
江宁	toponym
porto-novo	transcribed toponym
Guiana	transcribed toponym
Bolivia	transcribed toponym
中国甘肃网	other proper noun
民主与法制时报	other proper noun
北镇	toponym
糯米藕	noun
Banjul	transcribed toponym
Mali	transcribed toponym
中国服饰新闻网	other proper noun
中原铁道报	other proper noun
江苏商报	other proper noun
宗教报社	other proper noun
工商时报	other proper noun
家庭医生报	other proper noun
提拉米苏	noun
徐闻	toponym
台中时报	other proper noun
亚洲娱乐网	other proper noun
华尔街日报网	other proper noun
北湖	toponym
市场报	other proper noun
曲奇饼干	noun
昌黎	toponym
参考消息	other proper noun
今日周刊	other proper noun
佛山日报	other proper noun
南阳日报	other proper noun
中国江苏网	other proper noun
Egypt	transcribed toponym
重庆商报	other proper noun
安提瓜岛	toponym
当代生活报	other proper noun
brasilia	transcribed toponym
Georgia	transcribed toponym
湖北电力报	other proper noun
Monaco	transcribed toponym
新闻晚报	other proper noun
癸	numeral
乔治亚苏维埃社会主义共和国	toponym
东明	toponym
photoshop	software	proper	noun
guatemala	transcribed toponym
尼玛	toponym
中国网	other proper noun
Hamilton	transcribed toponym
Mauritania	transcribed toponym
安徽交通报	other proper noun
余干	toponym
正安	toponym
珠江商报	other proper noun
东方财经	other proper noun
老友报	other proper noun
中国医学论坛报	other proper noun
中国美容时尚	other proper noun
电脑报	other proper noun
上海科技报	other proper noun
Belgium	transcribed toponym
腊味合蒸	noun
重庆在线	other proper noun
荥阳	toponym
银耳汤	noun
济南时报	other proper noun
菏泽生活网	other proper noun
温州日报	other proper noun
河源网	other proper noun
Chad	transcribed toponym
Nepal	transcribed toponym
berlin	transcribed toponym
沈阳广播电台	other proper noun
河北广播电台	other proper noun
义乌日报	other proper noun
上方网	other proper noun
闽北日报	other proper noun
WE周报	other proper noun
中国经济通讯社	media	proper	noun
21世纪经济报道	other proper noun
St._Lucia	transcribed toponym
vientiane	transcribed toponym
内比都	transcribed toponym
科技日报	other proper noun
紫菜包饭	noun
烟台日报	other proper noun
白灼菜心	noun
中国时报	other proper noun
Qatar	transcribed toponym
汉滨	toponym
肉片炒青椒	noun
首尔	toponym
金门日报	other proper noun
赫山	toponym
组织人事报	other proper noun
宝山	toponym
洞头	toponym
固始	toponym
青年参考	other proper noun
Male_(Maale)	transcribed toponym
台湾时报	other proper noun
可乐鸡翅	noun
华夏汽车网	other proper noun
京华时报	other proper noun
银耳红枣汤	noun
端州	toponym
葡萄酒	noun
西乡塘区	toponym
中国国际广播电台	media	proper	noun
镜湖	toponym
Western_Samoa	transcribed toponym
harare	transcribed toponym
沙依巴克	toponym
鸽子汤	noun
深圳房产信息网	other proper noun
taxi	noun
维度女性网	other proper noun
海州	toponym
Accra	transcribed toponym
海曙	toponym
多米尼加岛	transcribed toponym
宁江	toponym
东坡肉	noun
北京青年周报	other proper noun
Canberra	transcribed toponym
万维家电网	other proper noun
New_Delhi	transcribed toponym
大武口	toponym
Gaborone	transcribed toponym
排骨汤	noun
天镇	toponym
奇虎	organization/group name
柳南	toponym
北京少年报	other proper noun
始县	toponym
东南早报	other proper noun
Doha	transcribed toponym
炒西瓜皮	noun
中青在线	other proper noun
sofia	transcribed toponym
慧聪汽车网	other proper noun
甘肃日报	other proper noun
醋溜白菜	noun
吉林在线	other proper noun
晶报	other proper noun
珠海广播电视	other proper noun
浙江之窗	other proper noun
黄州	toponym
东方体育日报	other proper noun
motor	noun
生活早报	other proper noun
长江商报	other proper noun
中国汽车消费网	other proper noun
八宝粥	noun
中国老年报	other proper noun
中山商报	other proper noun
Ankara	transcribed toponym
河池日报	other proper noun
延津	toponym
虎丘	toponym
遂宁日报	other proper noun
潮州日报	other proper noun
琥珀核桃	noun
红烧带鱼	noun
南岳	toponym
Malawi	transcribed toponym
爱意汽车网	other proper noun
Seychelles	transcribed toponym
崆峒	toponym
涡阳	toponym
云浮	toponym
爱宝宝网	other proper noun
新乡日报	other proper noun
西红柿炖牛腩	noun
伊通	toponym
太阳报	other proper noun
大众健康网	other proper noun
Vientiane	transcribed toponym
三河	toponym
淮上区	toponym
右江日报	other proper noun
福建侨报	other proper noun
证券时报网	other proper noun
千山晚报	other proper noun
大特克	toponym
新快报	other proper noun
弋江区	toponym
Bulgaria	transcribed toponym
映象网	other proper noun
Helsinki	transcribed toponym
新诺中国轿车网	other proper noun
MSN	other proper noun
鹤城	toponym
首都之窗	other proper noun
tegucigalpa	transcribed toponym
长春广播电台	other proper noun
中国食品报	other proper noun
千龙网	other proper noun
Suva	transcribed toponym
广西工人报	other proper noun
liner	noun
陕西卫视	other proper noun
墨脱	toponym
新报	other proper noun
婺城	toponym
Charlotte_Amalie	transcribed toponym
成都日报	other proper noun
Guatemala	transcribed toponym
云岩	toponym
东方早报	other proper noun
Yaounde	transcribed toponym
gibraltar	transcribed toponym
马绍尔群岛	transcribed toponym
搜狐	other proper noun
河南新闻网	other proper noun
Nuku'alofa	transcribed toponym
金边	transcribed toponym
农业科技报	other proper noun
印江	toponym
垣曲	toponym
医药网	other proper noun
Fort-De-France	transcribed toponym
糟溜鱼片	noun
Grenada	transcribed toponym
香卤鹌鹑蛋	noun
比特网	other proper noun
基督教论坛报	other proper noun
通信产业报	other proper noun
额敏	toponym
monrovia	transcribed toponym
曲阳县	toponym
糖醋鲤鱼	noun
Latvia	transcribed toponym
邢台新闻网	other proper noun
城市画报	other proper noun
飞象网	other proper noun
加格达奇	toponym
life	noun
抚远	toponym
teheran	transcribed toponym
南宁晚报	other proper noun
Road_Town	transcribed toponym
新洲	toponym
曲江区	toponym
nouakchott	transcribed toponym
汝州	toponym
秀峰	toponym
中小学电脑报	other proper noun
全麦面包	noun
阿里宝宝网	other proper noun
陕西电视台	other proper noun
新都市报	other proper noun
都市家庭报	other proper noun
烤鱼	noun
帕里基尔	transcribed toponym
有轨电车	noun
武江	toponym
联邦企业集团	other proper noun
龙马潭	toponym
橄榄树电脑资讯	other proper noun
精品健康导刊	other proper noun
东营日报	other proper noun
P'yongyang	transcribed toponym
咖喱鸡	noun
球报	other proper noun
Pclady	other proper noun
绍兴晚报	other proper noun
乐贝育儿网	other proper noun
office	software	proper	noun
赣榆	toponym
今日家庭报	other proper noun
亲贝贝网	other proper noun
天下财经网	other proper noun
辣子鸡	noun
中山日报	other proper noun
中国江西网	other proper noun
北川	toponym
Antigua	And	Barbuda	transcribed toponym
阳江日报	other proper noun
称多	toponym
召陵区	toponym
南通日报	other proper noun
漯河内陆特区报	other proper noun
武陟	toponym
咸蛋黄焗南瓜	noun
施甸	toponym
大众卫生报	other proper noun
湘东	toponym
酱爆鸡丁	noun
屌丝	noun
葱烧海参	noun
时尚元素	other proper noun
Kampala	transcribed toponym
北屯镇	toponym
小学生报	other proper noun
中新网	other proper noun
昂昂溪	toponym
五香毛豆	noun
中国社会报	other proper noun
南方都市报	other proper noun
Cambodia	transcribed toponym
魏都	toponym
伊通社	other proper noun
遂宁	toponym
环境与发展报	other proper noun
时事社	other proper noun
太平洋汽车网	other proper noun
泰州日报	other proper noun
fort-de-france	transcribed toponym
临渭	toponym
中国企业网	other proper noun
鱼香茄子	noun
徽州	toponym
塞勒姆	transcribed toponym
龙亭	toponym
鹿城	toponym
Ashgabat	transcribed toponym
糖三角	noun
凉州	toponym
人民邮电	other proper noun
南充日报	other proper noun
洛阳晚报	other proper noun
南国早报	other proper noun
中东社	other proper noun
土豆泥	noun
镇雄	toponym
Sao_Tome_And_Principe	transcribed toponym
左江日报	other proper noun
联合晚报	other proper noun
青白江	toponym
糖炒栗子	noun
炸酱面	noun
夏邑	toponym
Dublin	transcribed toponym
汕尾日报	other proper noun
台中晚报	other proper noun
科技资讯网	other proper noun
蓑衣黄瓜	noun
玉州	toponym
湘桥	toponym
临泉	toponym
焉耆	toponym
莫尔兹比港	transcribed toponym
小鸡炖蘑菇	noun
百色新闻网	other proper noun
霍林郭勒	toponym
连江县政府	other proper noun
九州汽车网	other proper noun
鹤壁	toponym
沧浪	toponym
渤海网	other proper noun
每日商报	other proper noun
Monarchy	transcribed toponym
车神榜网	other proper noun
文学报	other proper noun
扬州新闻网	other proper noun
cairo	transcribed toponym
大唐	organization/group name
中国国际美容网	other proper noun
鸡蛋羹	noun
清蒸武昌鱼	noun
皮蛋瘦肉粥	noun
djibouti	transcribed toponym
大连日报	other proper noun
Liberia	transcribed toponym
华文在线网	other proper noun
亚当斯敦	transcribed toponym
New_Zealand	transcribed toponym
aviation	noun
Hroot	other proper noun
上海广播电台	other proper noun
中国石化报	other proper noun
京江晚报	other proper noun
辰	numeral
左贡	toponym
三星	organization/group name
Saudi_Arabia	transcribed toponym
Ottawa	transcribed toponym
镇赉	toponym
太原新闻网	other proper noun
Dakar	transcribed toponym
大庆晚报	other proper noun
斯普林菲尔德	toponym
艾奥瓦	transcribed toponym
国际金融报	other proper noun
武都区	toponym
Caracas	transcribed toponym
戊	numeral
阿城区	toponym
汉网	other proper noun
育儿网	other proper noun
中国工商报	other proper noun
中关村商情网	other proper noun
信阳广播电视报	other proper noun
Ulaanbaatar	transcribed toponym
延边新闻网	other proper noun
戴尔	organization/group name
龟苓膏	noun
高唐	toponym
Moroni	transcribed toponym
华东新闻	other proper noun
V1周报	other proper noun
windhoek	transcribed toponym
索尔兹伯里	transcribed toponym
Philippines	transcribed toponym
玉林日报	other proper noun
颍州	toponym
煎蛋	noun
江苏电力报	other proper noun
旅游卫视	other proper noun
人民网	other proper noun
香港商报	other proper noun
福建电视台	other proper noun
Palestine	transcribed toponym
菠菜塔	noun
Freetown	transcribed toponym
许昌日报	other proper noun
东江时报	other proper noun
文汇报	other proper noun
jet	noun
北京家居网	other proper noun
Nuuk	transcribed toponym
南昌晚报	other proper noun
El_Salvador	transcribed toponym
宾夕法尼亚	transcribed toponym
Armenia	transcribed toponym
广阳	toponym
瑞丽网	other proper noun
奢华志网	other proper noun
British	Virgin	Islands	transcribed toponym
新疆电视台	other proper noun
中国汽车工业信息网	other proper noun
棒棒鸡	noun
镇坪	toponym
朱巴	transcribed toponym
精神文明报	other proper noun
北京晚报	other proper noun
湖南在线	other proper noun
安莎社	other proper noun
鄂城	toponym
车品网	other proper noun
车天下	other proper noun
春城晚报	other proper noun
池州日报	other proper noun
陕西广播电台	other proper noun
中国教育考试网	other proper noun
荥经	toponym
Washington,_Dc	transcribed toponym
Timor	transcribed toponym
大同日报	other proper noun
深圳广播电台	other proper noun
电脑商网	other proper noun
四川经济报	other proper noun
燕赵晚报	other proper noun
conakry	transcribed toponym
爱达荷	transcribed toponym
长岛	transcribed toponym
华夏时报	other proper noun
焦作日报	other proper noun
临西	toponym
名城早报	other proper noun
kuala_lumpur	transcribed toponym
上海电视台	other proper noun
广西电力报	other proper noun
客轮飞机	noun
高新技术产业报	other proper noun
Offices_In_Yaren_District	transcribed toponym
每日甘肃	other proper noun
河北广电网	other proper noun
台州日报	other proper noun
成都电视台	other proper noun
中国广播网	media	proper	noun
adamstown	transcribed toponym
尼克西亚	toponym
汽车市场网	other proper noun
广西广播电台	other proper noun
中央社	media	proper	noun
中国计算机报	other proper noun
阆中	toponym
柳州日报	other proper noun
中华商务网	other proper noun
电子报	other proper noun
哈尔滨日报	other proper noun
证券时报	other proper noun
鸡蛋糕	noun
凉拌海带丝	noun
华西都市报	other proper noun
aircraft	noun
North_Korea	transcribed toponym
Kiev	transcribed toponym
台湾新生报	other proper noun
中青网	other proper noun
融资网	other proper noun
源城	toponym
北斗手机网	other proper noun
辽宁日报海外版	other proper noun
Italy	transcribed toponym
城市快报	other proper noun
海报网	other proper noun
大连广播电台	other proper noun
文山	toponym
环球财经网	other proper noun
中关村在线	other proper noun
Singapore	transcribed toponym
Tunisia	transcribed toponym
政和	toponym
叫花鸡	noun
Oman	transcribed toponym
江苏邮电报电信	other proper noun
西安热线	other proper noun
鹤庆	toponym
黑龙江广播电台	other proper noun
华文在线	other proper noun
托皮卡	toponym
民用航空	noun
中国金融地产网	other proper noun
云阳	toponym
深圳汽车大世界	other proper noun
saipan	transcribed toponym
人民日报	other proper noun
峰峰矿区	toponym
宣恩	toponym
Djibouti	transcribed toponym
Dominica	transcribed toponym
Central_African_Republic	transcribed toponym
舟山晚报	other proper noun
麻酱豆角	noun
秦淮	toponym
汽车世界中文网	other proper noun
江西广播电台	other proper noun
东莞阳光网	other proper noun
世界体育周报	other proper noun
疏勒	toponym
高邮日报	other proper noun
拉萨晚报	other proper noun
大庆车网	other proper noun
oslo	transcribed toponym
南方体育	other proper noun
半岛网	other proper noun
Belize	transcribed toponym
东宁	toponym
河南卫视	other proper noun
南方电视台	other proper noun
旺报	other proper noun
jerusalem	transcribed toponym
大渝网	other proper noun
东方网	other proper noun
定兴	toponym
新华日报	other proper noun
星岛日报	other proper noun
九转大肠	noun
wellington	transcribed toponym
台安	toponym
沈阳网	other proper noun
文成	toponym
Hungary	transcribed toponym
南京都市网	other proper noun
西安商报	other proper noun
糖醋里脊	noun
韩联社	other proper noun
新民网	other proper noun
市场信息报	other proper noun
投资中国	other proper noun
工农区	toponym
峄城	toponym
Senegal	transcribed toponym
Tashkent	transcribed toponym
腊八粥	noun
大河报	other proper noun
面茶	noun
滨城	toponym
玉溪日报	other proper noun
经济信息时报	other proper noun
汤加王国	transcribed toponym
巴斯特尔	transcribed toponym
外滩画报	other proper noun
咸安	toponym
包河	toponym
汽车点评网	other proper noun
西湖牛肉羹	noun
沈阳今报	other proper noun
潍坊日报	other proper noun
发糕	noun
联合报系	other proper noun
焦糖布丁	noun
朝天	toponym
慧聪网	other proper noun
Finland	transcribed toponym
云南日报网	other proper noun
高港	toponym
文圣	toponym
辣子鸡丁	noun
贡井	toponym
中国旅行网	other proper noun
轮船	noun
中华读书报	other proper noun
Somalia	transcribed toponym
中国经营报	other proper noun
银川晚报	other proper noun
山西广播电台	other proper noun
安道尔共和国	toponym
南国都市报	other proper noun
中国网络电视台	media	proper	noun
乌苏	toponym
浦江	toponym
Bermuda	transcribed toponym
海峡摄影时报	other proper noun
岑溪	toponym
水母网	other proper noun
Ghana	transcribed toponym
Cyprus	transcribed toponym
音乐周报	other proper noun
法属波利尼西亚	transcribed toponym
解放牛网	other proper noun
邯郸晚报	other proper noun
西塞山	toponym
宜宾晚报	other proper noun
崇信	toponym
双台子	toponym
中国税务网	other proper noun
Kabul	transcribed toponym
烈山	toponym
罗德城	transcribed toponym
江苏经济报	other proper noun
monarchy	transcribed toponym
哈尔滨广播电台	other proper noun
Belgrade	transcribed toponym
朝中社	other proper noun
中国卫浴网	other proper noun
平安健康网	other proper noun
网络编辑网	other proper noun
零陵区	toponym
房龙网	other proper noun
Beijing	transcribed toponym
纺织导报	other proper noun
固镇	toponym
西安广播电台	other proper noun
中国兰州网	other proper noun
珊瑚金钩	noun
美术报	other proper noun
碾子山	toponym
沂蒙晚报	other proper noun
消费日报	other proper noun
大洋网	other proper noun
克孜勒苏	toponym
驻马店日报	other proper noun
黄河口晚刊	other proper noun
余额宝	other proper noun
都市快报	other proper noun
中国青年报	other proper noun
鲁中晨报	other proper noun
caracas	transcribed toponym
文萃	other proper noun
nicosia	transcribed toponym
英语辅导报	other proper noun
Sao_Tome_and_Principe	transcribed toponym
福州日报	other proper noun
大新	toponym
kyyiv	transcribed toponym
俄克拉何马城	toponym
岳麓	toponym
夏洛特阿马利亚	toponym
西部网	other proper noun
新源	toponym
夏河	toponym
巧克力蛋糕	noun
图木舒克	toponym
燕赵都市报	other proper noun
南方周末	other proper noun
青岛日报	other proper noun
Switzerland	transcribed toponym
派	noun-verb
玉屏	toponym
神木	toponym
羊城地铁报	other proper noun
大鹏新闻网	other proper noun
睢阳	toponym
霞山	toponym
黄石港	toponym
晋宁	toponym
享活志	other proper noun
木须肉	noun
新易在线网	other proper noun
南方网	other proper noun
碧海银沙	other proper noun
楚天都市报	other proper noun
学习时报	other proper noun
赣南日报	other proper noun
水晶虾饺	noun
报刊文摘	other proper noun
全景网	other proper noun
东方热线	other proper noun
佛蒙特	transcribed toponym
云溪	toponym
河南蒙古族自治县	toponym
半岛都市报	other proper noun
大客车	noun
榆阳	toponym
train	noun
大秦网	other proper noun
中国政府采购网	other proper noun
作文评点报	other proper noun
宁波晚报	other proper noun
贝贝客育儿网	other proper noun
萨诸塞	transcribed toponym
八道江	toponym
台州晚报	other proper noun
汴梁晚报	other proper noun
辽宁热线	other proper noun
西藏广播电台	other proper noun
北京广播电台	other proper noun
黑龙江农村报	other proper noun
hamilton	transcribed toponym
合肥万家热线	other proper noun
天津汽车品牌网	other proper noun
厦门广播电台	other proper noun
产后妈妈网	other proper noun
二道	toponym
邹平	toponym
肉丸	noun
长沙晚报	other proper noun
青岛电视台	other proper noun
decker	noun
湖南汽车网	other proper noun
中国商报	other proper noun
云南电视台	other proper noun
炒莴笋	noun
文汇读书周报	other proper noun
Lisbon	transcribed toponym
电脑爱好者网	other proper noun
江西日报	other proper noun
奥古斯塔	transcribed toponym
开福	toponym
信州	toponym
中国教育报	other proper noun
淇滨晚报	other proper noun
湖南卫视	other proper noun
泽普	toponym
努美阿	transcribed toponym
中国医药网	other proper noun
银耳莲子羹	noun
Sweden	transcribed toponym
牡丹晚报	other proper noun
河北电视台	other proper noun
夏洛特阿马利亚	transcribed toponym
菠菜炒鸡蛋	noun
澎湖日报	other proper noun
深圳特区报	other proper noun
鸡蛋饼	noun
Khartoum	transcribed toponym
grand_turk	transcribed toponym
国际经贸消息	other proper noun
汉沽	toponym
粉蒸排骨	noun
武进	toponym
原阳	toponym
互联天地	other proper noun
圣菲	toponym
Chile	transcribed toponym
番禹日报	other proper noun
南方卫视	other proper noun
齐鲁热线	other proper noun
任城	toponym
武汉晚报	other proper noun
French_Polynesia	transcribed toponym
Yugoslavia	transcribed toponym
酷爱女性网	other proper noun
巢湖日报	other proper noun
The_Bahamas	transcribed toponym
长春电视台	other proper noun
paris	transcribed toponym
当代女报	other proper noun
江西电视台	other proper noun
云梦	toponym
Bissau	transcribed toponym
客机	noun
云安	toponym
青年日报	other proper noun
北塘	toponym
肉松面包	noun
领航汽车网	other proper noun
伍家岗	toponym
Indonesia	transcribed toponym
西部开发报	other proper noun
红烧排骨	noun
远洋班轮	noun
Tallinn	transcribed toponym
新头壳	other proper noun
悦己网	other proper noun
中国通信网	other proper noun
新华网	other proper noun
贵州广播电台	other proper noun
thimphu	transcribed toponym
当代健康报	other proper noun
盐边	toponym
酸奶蛋糕	noun
Burundi	transcribed toponym
生活日报	other proper noun
CNET科技资讯网	other proper noun
自贡日报	other proper noun
猪肉脯	noun
爆炒腰花	noun
Bangui	transcribed toponym
Cuba	transcribed toponym
Budapest	transcribed toponym
brussels	transcribed toponym
衢州日报	other proper noun
巴中日报	other proper noun
厦门晚报	other proper noun
工商晚报	other proper noun
亲亲宝宝网	other proper noun
新京报网	other proper noun
贴吧	noun
中国早教网	other proper noun
武邑	toponym
蛇口消息报	other proper noun
梧州日报	other proper noun
深圳之窗	other proper noun
豆沙面包	noun
学习报	other proper noun
宿城	toponym
吴起县	toponym
大悟	toponym
东莞时报	other proper noun
南海网	other proper noun
秀洲	toponym
长治日报	other proper noun
荷叶粉蒸肉	noun
漾濞	toponym
辽沈晚报	other proper noun
苦瓜炒鸡蛋	noun
广东广播电台	other proper noun
让胡路	toponym
中国集报信息	other proper noun
馒头片	noun
英属维尔京群岛	transcribed toponym
烧茄子	noun
光明网	other proper noun
广州视窗	other proper noun
皮蛋豆腐	noun
绵阳晚报	other proper noun
kingston	transcribed toponym
镇巴	toponym
路易斯安那	transcribed toponym
周至	toponym
port-au-prince	transcribed toponym
渭城	toponym
诗礼银杏	noun
韶关家园网	other proper noun
Mogadishu	transcribed toponym
沈阳车市网	other proper noun
新民生报	other proper noun
弓长岭	toponym
bissau	transcribed toponym
二连浩特	toponym
东方家庭报	other proper noun
上海证券报	other proper noun
救生圈	noun
锅包肉	noun
石家庄新闻网	other proper noun
广州文摘报	other proper noun
kowait	transcribed toponym
汽车与运动	other proper noun
51汽车网	other proper noun
河南广播电视报	other proper noun
六一宝宝网	other proper noun
太平洋亲子	other proper noun
Lima	transcribed toponym
法兰西堡	transcribed toponym
劲报	other proper noun
浙江广播电视报	other proper noun
Belmopan	transcribed toponym
青岛广播电台	other proper noun
班轮	noun
Peru	transcribed toponym
praia	transcribed toponym
锦州日报	other proper noun
涪城	toponym
翠屏	toponym
天津广播电台	other proper noun
头屯河	toponym
Andorra	La	Vella	transcribed toponym
河北经济日报	other proper noun
信息日报	other proper noun
鸭血粉丝汤	noun
钱江晚报	other proper noun
石狮日报	other proper noun
banjul	transcribed toponym
湖州广播电视报	other proper noun
紫云	toponym
lusaka	transcribed toponym
上海环境报	other proper noun
铁山	toponym
beirut	transcribed toponym
北方新闻网	other proper noun
San_Marino	transcribed toponym
Brussels	transcribed toponym
南达科他	toponym
安徽广播电视报	other proper noun
晚霞报	other proper noun
珠江时报	other proper noun
中国融资网	other proper noun
好孩子育儿网	other proper noun
雁山	toponym
南中报	other proper noun
塞班	transcribed toponym
tube	noun
船	noun
中国贸易报	other proper noun
packet	noun
丙	numeral
腊肉	noun
Seoul	transcribed toponym
dublin	transcribed toponym
新疆广播电视报	other proper noun
泉州晚报海外版	other proper noun
红河日报	other proper noun
重庆青年报	other proper noun
芝士蛋糕	noun
37C医学网	other proper noun
莆田晚报	other proper noun
泉州晚报	other proper noun
belgrade	transcribed toponym
Papeete	transcribed toponym
cabin	noun
牡丹江日报	other proper noun
HEA家电网	other proper noun
齐鲁晚报	other proper noun
i时代	other proper noun
suva	transcribed toponym
上城	toponym
France	transcribed toponym
中国汽车动态网	other proper noun
Bridgetown	transcribed toponym
黑龙江卫视	other proper noun
河北新闻网	other proper noun
Sri_Lanka	transcribed toponym
山东新闻网	other proper noun
家庭教育时报	other proper noun
醋溜土豆丝	noun
窝窝头	noun
美联社	media	proper	noun
旅行报	other proper noun
冬瓜汤	noun
manila	transcribed toponym
中国气象报	other proper noun
麻辣小龙虾	noun
圣多美及普林西比民主共和国	transcribed toponym
水磨沟	toponym
Canada	transcribed toponym
河北商报	other proper noun
中国商务会展网	other proper noun
皮特克恩岛	toponym
韭菜炒香干	noun
都会时报	other proper noun
拔丝苹果	noun
车讯网	other proper noun
戚墅堰	toponym
圣马利诺	transcribed toponym
Castries	transcribed toponym
巴南	toponym
白灼虾	noun
覃塘	toponym
新晚报	other proper noun
杭州广播电台	other proper noun
盖世汽车网	other proper noun
国语周刊	other proper noun
波斯尼亚和黑塞哥维那	toponym
乌兰	toponym
犍为	toponym
Namibia	transcribed toponym
北镇市	toponym
乌尔禾	toponym
华中网	other proper noun
迁安	toponym
Praia	transcribed toponym
bangui	transcribed toponym
宁波日报	other proper noun
站前	toponym
South_Korea	transcribed toponym
微信	other proper noun
掇刀	toponym
Benin	transcribed toponym
电脑之家	other proper noun
定南	toponym
河南青年网	other proper noun
湖州晚报	other proper noun
民营经济报	other proper noun
温州汽车网	other proper noun
延边卫视	other proper noun
金陵热线	other proper noun
bogota	transcribed toponym
武侯	toponym
香辣虾	noun
固镇县	toponym
Antigua	and	Barbuda	transcribed toponym
信报财经新闻	other proper noun
沂源	toponym
新法制报	other proper noun
dhaka	transcribed toponym
江苏广播电视报	other proper noun
沙河口	toponym
南鄂晚报	other proper noun
青山湖	toponym
santo_domingo	transcribed toponym
青岛晚报	other proper noun
bagdad	transcribed toponym
三亚网	other proper noun
扬州晚报	other proper noun
Lusaka	transcribed toponym
马朱罗	transcribed toponym
天津卫视	other proper noun
松北区	toponym
塞尔维亚	transcribed toponym
闽侯	toponym
国际日报中国版	other proper noun
panama	transcribed toponym
艾瑞网	other proper noun
汉堡	noun
海南电视台	other proper noun
朱诺	toponym
海绵蛋糕	noun
莆田侨乡时报	other proper noun
Pago_Pago	transcribed toponym
济宁日报	other proper noun
酸辣粉	noun
博山	toponym
赛罕	toponym
生日蛋糕	noun
奶昔	noun
启东	toponym
城子河	toponym
扬州广播电视报	other proper noun
盐焗鸡	noun
三晋都市报	other proper noun
重庆晨报	other proper noun
吉林科技报	other proper noun
少年日报	other proper noun
钟南山	personal	name
普利茅斯	transcribed toponym
迁西	toponym
热气球	noun
巴巴多斯岛	transcribed toponym
东兰	toponym
Beirut	transcribed toponym
上海经理人	other proper noun
天津网	other proper noun
马祖日报	other proper noun
东河	toponym
温州都市报	other proper noun
Pitcairn_Island	transcribed toponym
十堰广播电视报	other proper noun
boat	noun
乔治亚苏维埃社会主义共和国	transcribed toponym
贺州日报	other proper noun
永川区	toponym
公益时报	other proper noun
百付宝	other proper noun
辽宁电视台	other proper noun
健康宝贝网	other proper noun
贵阳晚报	other proper noun
中国演员报	other proper noun
西充	toponym
羊肉汤	noun
津市	toponym
元江	toponym
Phnom_Penh	transcribed toponym
中国家装家居网	other proper noun
中国建材报	other proper noun
八步	toponym
盐源	toponym
寒亭	toponym
法新社	other proper noun
bujumbura	transcribed toponym
教师报	other proper noun
奶黄包	noun
内乡	toponym
噶尔	toponym
riyadh	transcribed toponym
康科德	transcribed toponym
Panama	transcribed toponym
香辣烤鱼	noun
自立晚报	other proper noun
灞桥	toponym
Eritrea	transcribed toponym
太平洋亲子网	other proper noun
蒙特塞拉特岛	transcribed toponym
中国妇女报	other proper noun
兰州新闻网	other proper noun
时尚先生	other proper noun
检察日报	other proper noun
网上车市	other proper noun
瑙鲁	transcribed toponym
鲫鱼豆腐汤	noun
七台河日报	other proper noun
中国劳动保障报	other proper noun
TOM网	other proper noun
三湘都市报	other proper noun
错那	toponym
金家庄	toponym
公营报社	other proper noun
stockholm	transcribed toponym
家家网	other proper noun
逍遥津	other proper noun
炒面	noun
腐乳烧鸡翅	noun
godthab	transcribed toponym
canberra	transcribed toponym
金华新闻网	other proper noun
商都网	other proper noun
孜然羊肉	noun
Martinique	transcribed toponym
武宣	toponym
浙江广播电台	other proper noun
固元膏	noun
体育快报	other proper noun
博伊西	toponym
Yemen	transcribed toponym
贵州卫视	other proper noun
咖喱牛腩	noun
支付宝	other proper noun
甘肃电视台	other proper noun
Madagascar	transcribed toponym
西安广播电视报	other proper noun
金鹰报	other proper noun
海南都市网	other proper noun
中国花卉报	other proper noun
Andorra	transcribed toponym
dakar	transcribed toponym
舟曲	toponym
田阳	toponym
islamabad	transcribed toponym
成都晚报	other proper noun
山西卫视	other proper noun
英德	toponym
裕民	toponym
Libya	transcribed toponym
联合早报网	other proper noun
尉犁	toponym
San_Juan	transcribed toponym
宁波电视台	other proper noun
mexico	transcribed toponym
颍泉	toponym
打卤面	noun
广州电视台	other proper noun
纳雍	toponym
中国房地产报	other proper noun
淮安日报	other proper noun
Uzbekistan	transcribed toponym
银河网	other proper noun
湖南日报	other proper noun
Netherlands	transcribed toponym
华龙网	other proper noun
泡椒凤爪	noun
多多育儿网	other proper noun
地三鲜	noun
硅谷动力	other proper noun
中国电子报	other proper noun
壶关	toponym
St._Vinceorganization/group name_and_the_Grenadines	transcribed toponym
梅莱凯奥克	transcribed toponym
盐山	toponym
牛奶炖蛋	noun
Guinea-Bissau	transcribed toponym
救生艇	noun
roseau	transcribed toponym
Togo	transcribed toponym
北京晨报	other proper noun
广州日报	other proper noun
气垫船	noun
蓬江	toponym
牡丹江晨报	other proper noun
武陵都市报	other proper noun
中国日报网	other proper noun
莱西日报	other proper noun
巧家	toponym
红烧鸡翅	noun
Montserrat	transcribed toponym
Macedonia	transcribed toponym
特立尼达和多巴哥	transcribed toponym
金山屯	toponym
南瓜粥	noun
带岭	toponym
读者报	other proper noun
vienna	transcribed toponym
宝鸡日报	other proper noun
湖南新闻网	other proper noun
华南新闻	other proper noun
Cameroon	transcribed toponym
东方卫视	other proper noun
安徽电视台	other proper noun
trolleybus	noun
victoria	transcribed toponym
乐活都市网	other proper noun
Abu_Dhabi	transcribed toponym
青年报	other proper noun
万州	toponym
新余日报	other proper noun
莫尔兹比港	toponym
车168	other proper noun
大旗网	other proper noun
澎湖时报	other proper noun
蒜泥茄子	noun
龙子湖区	toponym
mogadishu	transcribed toponym
21cn	other proper noun
水曜新闻	other proper noun
西安晚报	other proper noun
邮轮	noun
金羊网	other proper noun
井陉矿	toponym
爱护她母婴网	other proper noun
萨克拉门托	transcribed toponym
扬州炒饭	noun
红海湾经济开发试验区	toponym
甘肃经济网	other proper noun
福建之窗	other proper noun
辣白菜	noun
new_delhi	transcribed toponym
新商报	other proper noun
中国企业新闻网	other proper noun
Dhaka	transcribed toponym
Gabon	transcribed toponym
庐阳	toponym
深泽	toponym
今日新闻网	other proper noun
亚洲新闻通讯社	other proper noun
东方新报	other proper noun
油泼鱼	noun
墨玉	toponym
茶叶蛋	noun
蒜蓉油麦菜	noun
赛门提克	organization/group name
临淄	toponym
辽宁法制报	other proper noun
全球教育网	other proper noun
FACE妆点网	other proper noun
淘宝网	other proper noun
投资界	other proper noun
锦州新闻网	other proper noun
拍黄瓜	noun
上海译报	other proper noun
Israel	transcribed toponym
青岛财经日报	other proper noun
鄞州	toponym
大楚网	other proper noun
汉南	toponym
YOKA时尚网	other proper noun
八桂都市报	other proper noun
大祥	toponym
香巴拉家居网	other proper noun
葱油饼	noun
路透社	other proper noun
valley	transcribed toponym
酸辣土豆丝	noun
宫保鸡丁	noun
当代财富报	other proper noun
粉蒸肉	noun
广东工商报	other proper noun
手机世界	other proper noun
大姚	toponym
长城在线	other proper noun
安徽新闻网	other proper noun
涡轮喷气飞机	noun
乐东	toponym
Malta	transcribed toponym
深圳法制报	other proper noun
古城热线	other proper noun
灵宝晚报	other proper noun
粮油市场报	other proper noun
辽阳新闻网	other proper noun
丁	numeral
it168	other proper noun
Skopje	transcribed toponym
安徽商报	other proper noun
上海在线	other proper noun
苹果公司	organization/group name
三九健康网	other proper noun
苹果醋	noun
图瓦卢	transcribed toponym
北京日报	other proper noun
开发区导报	other proper noun
定陶	toponym
中原硅谷网	other proper noun
am730	other proper noun
淘宝	organization/group name
中国财经网	other proper noun
Saint_John's	transcribed toponym
照烧鸡	noun
湖北卫视	other proper noun
西乡塘	toponym
东台日报	other proper noun
民众日报	other proper noun
宝贝网	other proper noun
烟台晚报	other proper noun
Nicaragua	transcribed toponym
Tegucigalpa	transcribed toponym
中国网友报	other proper noun
陕西日报	other proper noun
明报	other proper noun
卡森城	transcribed toponym
pago_pago	transcribed toponym
51健康网	other proper noun
南湖晚报	other proper noun
安徽经济报	other proper noun
云龙	toponym
St._Kitts_And_Nevis	transcribed toponym
Harare	transcribed toponym
船营	toponym
中国邮政报	other proper noun
Iraq	transcribed toponym
天镇县	toponym
Kowait	transcribed toponym
镇沅	toponym
河南网	other proper noun
望谟	toponym
菊花酥	noun
toshkent	transcribed toponym
小熊在线	other proper noun
Strip	transcribed toponym
杭州日报	other proper noun
香港卫视	media	proper	noun
温州晚报	other proper noun
前锋招标日报	other proper noun
andorra_la_vella	transcribed toponym
广西政法报	other proper noun
西安电视台	other proper noun
鹤壁日报	other proper noun
三明日报	other proper noun
沪江网	other proper noun
炒饼	noun
paramaribo	transcribed toponym
瓜州	toponym
牛肉炖土豆	noun
北京法制报	other proper noun
烤鸭	noun
时尚伊人网	other proper noun
中国轨道交通网	other proper noun
port_louis	transcribed toponym
茂名晚报	other proper noun
湘声报	other proper noun
名城苏州	other proper noun
天津热线	other proper noun
大屿报	other proper noun
白菜炖豆腐	noun
Cairo	transcribed toponym
Maputo	transcribed toponym
时尚秀	other proper noun
Mozambique	transcribed toponym
freetown	transcribed toponym
天津在线	other proper noun
蔡甸	toponym
杏花岭	toponym
Saint_George's	transcribed toponym
湖南经济报	other proper noun
asmara	transcribed toponym
芝罘	toponym
蚌埠新闻网	other proper noun
飞机	noun
石锅拌饭	noun
家庭导报	other proper noun
平顶山日报	other proper noun
Republic_Of_The_Congo	transcribed toponym
湛河	toponym
青海新闻	other proper noun
圣卢西亚岛	transcribed toponym
包子	noun
回锅肉	noun
amman	transcribed toponym
美丽婚嫁网	other proper noun
冰皮月饼	noun
现代农村报	other proper noun
白碱滩	toponym
rome	transcribed toponym
小学生拼音报	other proper noun
浙江日报	other proper noun
Kingston	transcribed toponym
仲巴	toponym
明光	toponym
中国橱卫在线	other proper noun
炸香椿鱼	noun
盐津	toponym
滨江	toponym
西安新闻网	other proper noun